................................
................................
@...............................
................................
................................
................................
................................
................................
................................
................................
................................
................................
................................
................................
................................
................................
................................
................................
................................
................................
................................
..................##............
..................**............
..............##..**..##..##.....
..............**..**..**..**..
...%.....%....**..**..**..**.%.!
#####..######.**$$**$$**$$**####
*****$$******$**$$**$$**$$******
*************$**$$**$$**$$******
********************************