................................
................................
@...............................
................................
................................
..........#.....................
................................
................................
................................
................................
........#....#..................
................................
................................
................................
................................
......#.........#...............
................................
................................
................................
................................
#...#...........................
................................
................................
......................%....%...!
...................#############
..#.............................
................................
................................
................................
$$$$$$$$$$$$$$$$$$$$$$$$$$$$$$$$