........................................
........................................
........................................
........................................
........................................
........................................
........................................
........................................
@.%...%...%.............................
########################################
........................................
........................................