................................
................................
@...............................
................................
................................
................................
................................
................................
................................
................................
................................
................................
................................
................................
................................
................................
.............................%.!
##..##..##..##..##..##..##..####
................................
................................
................................
................................
................................
................................
................................
................................
................................
................................
................................
$$$$$$$$$$$$$$$$$$$$$$$$$$$$$$$$