........................................
........................................
........................................
........................................
@.......................................
########################################
........................................
........................................
........................................
........................................
........................................
........................................
