................................
................................
@...............................
................................
................................
................................
................................
................................
................................
................................
................................
................................
................................
................................
................................
................................
................................
................................
................................
................................
................................
................................
................................
................................
................................
...%.......%....................
#####################..#########
*********************$$*********
*********************$$*********
********************************