................................
................................
................................
................................
................................
@..................%............
..................###...........
................................
................................
................................
...............%................
..............###...............
................................
................................
................................
...........%....................
..........###...................
................................
................................
................................
.......%...............%........
......###............####.......
................................
................................
................................
....%..........................!
#..###....................######
*..***$$$$$$$$$$$$$$$$$$$$******
*..***$$$$$$$$$$$$$$$$$$$$******
*..*****************************