................................
................................
@...............................
................................
................................
................................
................................
................................
................................
................................
................................
................................
................................
................................
................................
................................
................................
................................
................................
................................
................................
................................
................................
................................
................................
......%....%.....%........%....!
##..#################..#########
**$$*****************$$*********
**$$*****************$$*********
********************************