................................
................................
@...............................
................................
................................
................................
................................
................................
................................
................................
................................
................................
................................
................................
................................
................................
................................
................................
................................
................................
................................
................................
................................
................*...............
................*...............
...%.......%....*..............!
#####################..#########
*********************$$*********
*********************$$*********
********************************